instant,dteday,season,yr,mnth,weathersit,hum,casual,registered,cnt
1,2011-01-01,1,0,1,2,0.805833,331,654,985
2,2011-01-02,1,0,1,2,0.696087,131,670,801
3,2011-01-03,1,0,1,1,0.437273,120,1229,1349
4,2011-01-04,1,0,1,1,0.590435,108,1454,1562
5,2011-01-05,1,0,1,1,0.436957,82,1518,1600
6,2011-01-06,1,0,1,1,0.518261,88,1518,1606
7,2011-01-07,1,0,1,2,0.498696,148,1362,1510
8,2011-01-08,1,0,1,2,0.535833,68,891,959
9,2011-01-09,1,0,1,1,0.434167,54,768,822
10,2011-01-10,1,0,1,1,0.482917,41,1280,1321
11,2011-01-11,1,0,1,2,0.686364,43,1220,1263
12,2011-01-12,1,0,1,1,0.599545,25,1137,1162
13,2011-01-13,1,0,1,1,0.470417,38,1368,1406
14,2011-01-14,1,0,1,1,0.537826,54,1367,1421
15,2011-01-15,1,0,1,2,0.49875,222,1026,1248
16,2011-01-16,1,0,1,1,0.48375,251,953,1204
17,2011-01-17,1,0,1,2,0.5375,117,883,1000
18,2011-01-18,1,0,1,2,0.861667,9,674,683
19,2011-01-19,1,0,1,2,0.741739,78,1572,1650
20,2011-01-20,1,0,1,2,0.538333,83,1844,1927
21,2011-01-21,1,0,1,1,0.457083,75,1468,1543
22,2011-01-22,1,0,1,1,0.4,93,888,981
23,2011-01-23,1,0,1,1,0.436522,150,836,986
24,2011-01-24,1,0,1,1,0.491739,86,1330,1416
25,2011-01-25,1,0,1,2,0.616957,186,1799,1985
26,2011-01-26,1,0,1,3,0.8625,34,472,506
27,2011-01-27,1,0,1,1,0.6875,15,416,431
28,2011-01-28,1,0,1,2,0.793043,38,1129,1167
29,2011-01-29,1,0,1,1,0.651739,123,975,1098
30,2011-01-30,1,0,1,1,0.722174,140,956,1096
31,2011-01-31,1,0,1,2,0.60375,42,1459,1501
32,2011-02-01,1,0,2,2,0.829565,47,1313,1360
33,2011-02-02,1,0,2,2,0.775417,72,1454,1526
34,2011-02-03,1,0,2,1,0.437826,61,1489,1550
35,2011-02-04,1,0,2,2,0.585217,88,1620,1708
36,2011-02-05,1,0,2,2,0.929167,100,905,1005
37,2011-02-06,1,0,2,1,0.568333,354,1269,1623
38,2011-02-07,1,0,2,1,0.738333,120,1592,1712
39,2011-02-08,1,0,2,1,0.537917,64,1466,1530
40,2011-02-09,1,0,2,2,0.494783,53,1552,1605
41,2011-02-10,1,0,2,1,0.437391,47,1491,1538
42,2011-02-11,1,0,2,1,0.506364,149,1597,1746
43,2011-02-12,1,0,2,1,0.544167,288,1184,1472
44,2011-02-13,1,0,2,1,0.457391,397,1192,1589
45,2011-02-14,1,0,2,1,0.375833,208,1705,1913
46,2011-02-15,1,0,2,1,0.314348,140,1675,1815
47,2011-02-16,1,0,2,1,0.423478,218,1897,2115
48,2011-02-17,1,0,2,1,0.505,259,2216,2475
49,2011-02-18,1,0,2,1,0.516667,579,2348,2927
50,2011-02-19,1,0,2,1,0.187917,532,1103,1635
51,2011-02-20,1,0,2,1,0.407826,639,1173,1812
52,2011-02-21,1,0,2,2,0.605,195,912,1107
53,2011-02-22,1,0,2,1,0.577778,74,1376,1450
54,2011-02-23,1,0,2,1,0.423043,139,1778,1917
55,2011-02-24,1,0,2,2,0.697391,100,1707,1807
56,2011-02-25,1,0,2,2,0.712174,120,1341,1461
57,2011-02-26,1,0,2,1,0.537917,424,1545,1969
58,2011-02-27,1,0,2,1,0.68,694,1708,2402
59,2011-02-28,1,0,2,2,0.876364,81,1365,1446
60,2011-03-01,1,0,3,1,0.535,137,1714,1851
61,2011-03-02,1,0,3,1,0.449583,231,1903,2134
62,2011-03-03,1,0,3,1,0.318333,123,1562,1685
63,2011-03-04,1,0,3,2,0.610417,214,1730,1944
64,2011-03-05,1,0,3,2,0.789167,640,1437,2077
65,2011-03-06,1,0,3,2,0.948261,114,491,605
66,2011-03-07,1,0,3,1,0.551304,244,1628,1872
67,2011-03-08,1,0,3,1,0.420833,316,1817,2133
68,2011-03-09,1,0,3,2,0.775417,191,1700,1891
69,2011-03-10,1,0,3,3,0.0,46,577,623
70,2011-03-11,1,0,3,2,0.649565,247,1730,1977
71,2011-03-12,1,0,3,1,0.594583,724,1408,2132
72,2011-03-13,1,0,3,1,0.527391,982,1435,2417
73,2011-03-14,1,0,3,1,0.496957,359,1687,2046
74,2011-03-15,1,0,3,2,0.655652,289,1767,2056
75,2011-03-16,1,0,3,2,0.776522,321,1871,2192
76,2011-03-17,1,0,3,1,0.602917,424,2320,2744
77,2011-03-18,1,0,3,1,0.525217,884,2355,3239
78,2011-03-19,1,0,3,1,0.379167,1424,1693,3117
79,2011-03-20,1,0,3,1,0.47375,1047,1424,2471
80,2011-03-21,2,0,3,2,0.737391,401,1676,2077
81,2011-03-22,2,0,3,1,0.624583,460,2243,2703
82,2011-03-23,2,0,3,2,0.839565,203,1918,2121
83,2011-03-24,2,0,3,2,0.805833,166,1699,1865
84,2011-03-25,2,0,3,1,0.495,300,1910,2210
85,2011-03-26,2,0,3,1,0.394167,981,1515,2496
86,2011-03-27,2,0,3,2,0.493913,472,1221,1693
87,2011-03-28,2,0,3,1,0.302174,222,1806,2028
88,2011-03-29,2,0,3,1,0.314167,317,2108,2425
89,2011-03-30,2,0,3,2,0.646667,168,1368,1536
90,2011-03-31,2,0,3,3,0.918333,179,1506,1685
91,2011-04-01,2,0,4,2,0.68625,307,1920,2227
92,2011-04-02,2,0,4,2,0.65375,898,1354,2252
93,2011-04-03,2,0,4,1,0.48,1651,1598,3249
94,2011-04-04,2,0,4,1,0.42625,734,2381,3115
95,2011-04-05,2,0,4,2,0.642083,167,1628,1795
96,2011-04-06,2,0,4,1,0.470833,413,2395,2808
97,2011-04-07,2,0,4,1,0.602917,571,2570,3141
98,2011-04-08,2,0,4,2,0.83625,172,1299,1471
99,2011-04-09,2,0,4,2,0.8775,879,1576,2455
100,2011-04-10,2,0,4,2,0.8575,1188,1707,2895
101,2011-04-11,2,0,4,2,0.716956,855,2493,3348
102,2011-04-12,2,0,4,2,0.739167,257,1777,2034
103,2011-04-13,2,0,4,2,0.819167,209,1953,2162
104,2011-04-14,2,0,4,1,0.540417,529,2738,3267
105,2011-04-15,2,0,4,1,0.67125,642,2484,3126
106,2011-04-16,2,0,4,3,0.888333,121,674,795
107,2011-04-17,2,0,4,1,0.479583,1558,2186,3744
108,2011-04-18,2,0,4,1,0.5425,669,2760,3429
109,2011-04-19,2,0,4,2,0.665833,409,2795,3204
110,2011-04-20,2,0,4,1,0.614167,613,3331,3944
111,2011-04-21,2,0,4,1,0.407083,745,3444,4189
112,2011-04-22,2,0,4,2,0.729583,177,1506,1683
113,2011-04-23,2,0,4,2,0.887917,1462,2574,4036
114,2011-04-24,2,0,4,2,0.810833,1710,2481,4191
115,2011-04-25,2,0,4,1,0.776667,773,3300,4073
116,2011-04-26,2,0,4,1,0.729167,678,3722,4400
117,2011-04-27,2,0,4,2,0.835417,547,3325,3872
118,2011-04-28,2,0,4,2,0.700833,569,3489,4058
119,2011-04-29,2,0,4,1,0.457083,878,3717,4595
120,2011-04-30,2,0,4,1,0.503333,1965,3347,5312
121,2011-05-01,2,0,5,2,0.762083,1138,2213,3351
122,2011-05-02,2,0,5,2,0.73,847,3554,4401
123,2011-05-03,2,0,5,2,0.697083,603,3848,4451
124,2011-05-04,2,0,5,2,0.737083,255,2378,2633
125,2011-05-05,2,0,5,1,0.444167,614,3819,4433
126,2011-05-06,2,0,5,1,0.59,894,3714,4608
127,2011-05-07,2,0,5,1,0.54125,1612,3102,4714
128,2011-05-08,2,0,5,1,0.631667,1401,2932,4333
129,2011-05-09,2,0,5,1,0.58875,664,3698,4362
130,2011-05-10,2,0,5,1,0.489167,694,4109,4803
131,2011-05-11,2,0,5,1,0.632917,550,3632,4182
132,2011-05-12,2,0,5,1,0.7475,695,4169,4864
133,2011-05-13,2,0,5,2,0.863333,692,3413,4105
134,2011-05-14,2,0,5,2,0.9225,902,2507,3409
135,2011-05-15,2,0,5,2,0.867083,1582,2971,4553
136,2011-05-16,2,0,5,1,0.787917,773,3185,3958
137,2011-05-17,2,0,5,2,0.837917,678,3445,4123
138,2011-05-18,2,0,5,2,0.87,536,3319,3855
139,2011-05-19,2,0,5,2,0.829583,735,3840,4575
140,2011-05-20,2,0,5,1,0.719583,909,4008,4917
141,2011-05-21,2,0,5,1,0.626667,2258,3547,5805
142,2011-05-22,2,0,5,1,0.749583,1576,3084,4660
143,2011-05-23,2,0,5,2,0.81,836,3438,4274
144,2011-05-24,2,0,5,2,0.740833,659,3833,4492
145,2011-05-25,2,0,5,1,0.69625,740,4238,4978
146,2011-05-26,2,0,5,1,0.6775,758,3919,4677
147,2011-05-27,2,0,5,1,0.65375,871,3808,4679
148,2011-05-28,2,0,5,1,0.729583,2001,2757,4758
149,2011-05-29,2,0,5,1,0.81875,2355,2433,4788
150,2011-05-30,2,0,5,1,0.685,1549,2549,4098
151,2011-05-31,2,0,5,1,0.636667,673,3309,3982
152,2011-06-01,2,0,6,2,0.677083,513,3461,3974
153,2011-06-02,2,0,6,1,0.305,736,4232,4968
154,2011-06-03,2,0,6,1,0.354167,898,4414,5312
155,2011-06-04,2,0,6,1,0.45625,1869,3473,5342
156,2011-06-05,2,0,6,2,0.6525,1685,3221,4906
157,2011-06-06,2,0,6,1,0.6,673,3875,4548
158,2011-06-07,2,0,6,1,0.597917,763,4070,4833
159,2011-06-08,2,0,6,1,0.622083,676,3725,4401
160,2011-06-09,2,0,6,2,0.568333,563,3352,3915
161,2011-06-10,2,0,6,1,0.605,815,3771,4586
162,2011-06-11,2,0,6,1,0.654583,1729,3237,4966
163,2011-06-12,2,0,6,1,0.747917,1467,2993,4460
164,2011-06-13,2,0,6,1,0.494583,863,4157,5020
165,2011-06-14,2,0,6,1,0.507083,727,4164,4891
166,2011-06-15,2,0,6,1,0.471667,769,4411,5180
167,2011-06-16,2,0,6,2,0.688333,545,3222,3767
168,2011-06-17,2,0,6,1,0.735833,863,3981,4844
169,2011-06-18,2,0,6,1,0.670417,1807,3312,5119
170,2011-06-19,2,0,6,2,0.666667,1639,3105,4744
171,2011-06-20,2,0,6,2,0.74625,699,3311,4010
172,2011-06-21,3,0,6,2,0.770417,774,4061,4835
173,2011-06-22,3,0,6,1,0.7075,661,3846,4507
174,2011-06-23,3,0,6,2,0.703333,746,4044,4790
175,2011-06-24,3,0,6,1,0.573333,969,4022,4991
176,2011-06-25,3,0,6,1,0.483333,1782,3420,5202
177,2011-06-26,3,0,6,1,0.513333,1920,3385,5305
178,2011-06-27,3,0,6,2,0.658333,854,3854,4708
179,2011-06-28,3,0,6,1,0.634167,732,3916,4648
180,2011-06-29,3,0,6,1,0.497917,848,4377,5225
181,2011-06-30,3,0,6,1,0.434167,1027,4488,5515
182,2011-07-01,3,0,7,1,0.39625,1246,4116,5362
183,2011-07-02,3,0,7,1,0.444583,2204,2915,5119
184,2011-07-03,3,0,7,2,0.6825,2282,2367,4649
185,2011-07-04,3,0,7,2,0.637917,3065,2978,6043
186,2011-07-05,3,0,7,1,0.590417,1031,3634,4665
187,2011-07-06,3,0,7,1,0.743333,784,3845,4629
188,2011-07-07,3,0,7,1,0.65125,754,3838,4592
189,2011-07-08,3,0,7,2,0.757917,692,3348,4040
190,2011-07-09,3,0,7,1,0.609167,1988,3348,5336
191,2011-07-10,3,0,7,1,0.578333,1743,3138,4881
192,2011-07-11,3,0,7,1,0.635833,723,3363,4086
193,2011-07-12,3,0,7,1,0.559167,662,3596,4258
194,2011-07-13,3,0,7,1,0.631667,748,3594,4342
195,2011-07-14,3,0,7,1,0.47625,888,4196,5084
196,2011-07-15,3,0,7,1,0.59125,1318,4220,5538
197,2011-07-16,3,0,7,1,0.585,2418,3505,5923
198,2011-07-17,3,0,7,1,0.604167,2006,3296,5302
199,2011-07-18,3,0,7,1,0.65125,841,3617,4458
200,2011-07-19,3,0,7,1,0.650417,752,3789,4541
201,2011-07-20,3,0,7,1,0.707083,644,3688,4332
202,2011-07-21,3,0,7,2,0.69125,632,3152,3784
203,2011-07-22,3,0,7,1,0.580417,562,2825,3387
204,2011-07-23,3,0,7,1,0.5,987,2298,3285
205,2011-07-24,3,0,7,1,0.550833,1050,2556,3606
206,2011-07-25,3,0,7,1,0.757083,568,3272,3840
207,2011-07-26,3,0,7,1,0.540833,750,3840,4590
208,2011-07-27,3,0,7,1,0.402917,755,3901,4656
209,2011-07-28,3,0,7,1,0.583333,606,3784,4390
210,2011-07-29,3,0,7,1,0.5425,670,3176,3846
211,2011-07-30,3,0,7,1,0.465833,1559,2916,4475
212,2011-07-31,3,0,7,1,0.480833,1524,2778,4302
213,2011-08-01,3,0,8,1,0.550833,729,3537,4266
214,2011-08-02,3,0,8,1,0.49125,801,4044,4845
215,2011-08-03,3,0,8,2,0.6575,467,3107,3574
216,2011-08-04,3,0,8,2,0.7575,799,3777,4576
217,2011-08-05,3,0,8,1,0.630833,1023,3843,4866
218,2011-08-06,3,0,8,2,0.755,1521,2773,4294
219,2011-08-07,3,0,8,1,0.752917,1298,2487,3785
220,2011-08-08,3,0,8,1,0.592083,846,3480,4326
221,2011-08-09,3,0,8,1,0.570417,907,3695,4602
222,2011-08-10,3,0,8,1,0.424167,884,3896,4780
223,2011-08-11,3,0,8,1,0.42375,812,3980,4792
224,2011-08-12,3,0,8,1,0.415,1051,3854,4905
225,2011-08-13,3,0,8,2,0.729583,1504,2646,4150
226,2011-08-14,3,0,8,2,0.8175,1338,2482,3820
227,2011-08-15,3,0,8,1,0.712083,775,3563,4338
228,2011-08-16,3,0,8,1,0.578333,721,4004,4725
229,2011-08-17,3,0,8,1,0.575417,668,4026,4694
230,2011-08-18,3,0,8,1,0.654583,639,3166,3805
231,2011-08-19,3,0,8,2,0.722917,797,3356,4153
232,2011-08-20,3,0,8,1,0.674167,1914,3277,5191
233,2011-08-21,3,0,8,1,0.77,1249,2624,3873
234,2011-08-22,3,0,8,1,0.47,833,3925,4758
235,2011-08-23,3,0,8,1,0.455417,1281,4614,5895
236,2011-08-24,3,0,8,1,0.605,949,4181,5130
237,2011-08-25,3,0,8,2,0.771667,435,3107,3542
238,2011-08-26,3,0,8,1,0.76125,768,3893,4661
239,2011-08-27,3,0,8,2,0.85,226,889,1115
240,2011-08-28,3,0,8,1,0.561765,1415,2919,4334
241,2011-08-29,3,0,8,1,0.554583,729,3905,4634
242,2011-08-30,3,0,8,1,0.548333,775,4429,5204
243,2011-08-31,3,0,8,1,0.597917,688,4370,5058
244,2011-09-01,3,0,9,1,0.639167,783,4332,5115
245,2011-09-02,3,0,9,2,0.727083,875,3852,4727
246,2011-09-03,3,0,9,1,0.716667,1935,2549,4484
247,2011-09-04,3,0,9,1,0.742083,2521,2419,4940
248,2011-09-05,3,0,9,2,0.790417,1236,2115,3351
249,2011-09-06,3,0,9,3,0.886957,204,2506,2710
250,2011-09-07,3,0,9,3,0.917083,118,1878,1996
251,2011-09-08,3,0,9,3,0.939565,153,1689,1842
252,2011-09-09,3,0,9,2,0.897917,417,3127,3544
253,2011-09-10,3,0,9,1,0.75375,1750,3595,5345
254,2011-09-11,3,0,9,1,0.71375,1633,3413,5046
255,2011-09-12,3,0,9,1,0.692174,690,4023,4713
256,2011-09-13,3,0,9,1,0.7125,701,4062,4763
257,2011-09-14,3,0,9,1,0.697083,647,4138,4785
258,2011-09-15,3,0,9,2,0.709167,428,3231,3659
259,2011-09-16,3,0,9,2,0.590417,742,4018,4760
260,2011-09-17,3,0,9,2,0.718333,1434,3077,4511
261,2011-09-18,3,0,9,1,0.695,1353,2921,4274
262,2011-09-19,3,0,9,2,0.69,691,3848,4539
263,2011-09-20,3,0,9,2,0.88125,438,3203,3641
264,2011-09-21,3,0,9,2,0.9,539,3813,4352
265,2011-09-22,3,0,9,2,0.902083,555,4240,4795
266,2011-09-23,4,0,9,2,0.9725,258,2137,2395
267,2011-09-24,4,0,9,2,0.8625,1776,3647,5423
268,2011-09-25,4,0,9,2,0.845,1544,3466,5010
269,2011-09-26,4,0,9,2,0.848333,684,3946,4630
270,2011-09-27,4,0,9,2,0.885417,477,3643,4120
271,2011-09-28,4,0,9,2,0.84875,480,3427,3907
272,2011-09-29,4,0,9,1,0.699167,653,4186,4839
273,2011-09-30,4,0,9,1,0.6475,830,4372,5202
274,2011-10-01,4,0,10,2,0.75375,480,1949,2429
275,2011-10-02,4,0,10,2,0.791667,616,2302,2918
276,2011-10-03,4,0,10,2,0.760833,330,3240,3570
277,2011-10-04,4,0,10,1,0.71,486,3970,4456
278,2011-10-05,4,0,10,1,0.647917,559,4267,4826
279,2011-10-06,4,0,10,1,0.620833,639,4126,4765
280,2011-10-07,4,0,10,1,0.684167,949,4036,4985
281,2011-10-08,4,0,10,1,0.70125,2235,3174,5409
282,2011-10-09,4,0,10,1,0.7275,2397,3114,5511
283,2011-10-10,4,0,10,1,0.73375,1514,3603,5117
284,2011-10-11,4,0,10,2,0.80875,667,3896,4563
285,2011-10-12,4,0,10,3,0.90625,217,2199,2416
286,2011-10-13,4,0,10,2,0.896667,290,2623,2913
287,2011-10-14,4,0,10,2,0.71625,529,3115,3644
288,2011-10-15,4,0,10,1,0.483333,1899,3318,5217
289,2011-10-16,4,0,10,1,0.486667,1748,3293,5041
290,2011-10-17,4,0,10,1,0.579583,713,3857,4570
291,2011-10-18,4,0,10,2,0.701667,637,4111,4748
292,2011-10-19,4,0,10,3,0.895217,254,2170,2424
293,2011-10-20,4,0,10,1,0.63625,471,3724,4195
294,2011-10-21,4,0,10,1,0.574167,676,3628,4304
295,2011-10-22,4,0,10,1,0.629167,1499,2809,4308
296,2011-10-23,4,0,10,1,0.74125,1619,2762,4381
297,2011-10-24,4,0,10,1,0.772083,699,3488,4187
298,2011-10-25,4,0,10,1,0.622917,695,3992,4687
299,2011-10-26,4,0,10,2,0.720417,404,3490,3894
300,2011-10-27,4,0,10,2,0.812917,240,2419,2659
301,2011-10-28,4,0,10,2,0.585833,456,3291,3747
302,2011-10-29,4,0,10,3,0.8825,57,570,627
303,2011-10-30,4,0,10,1,0.62375,885,2446,3331
304,2011-10-31,4,0,10,1,0.703333,362,3307,3669
305,2011-11-01,4,0,11,1,0.68375,410,3658,4068
306,2011-11-02,4,0,11,1,0.71875,370,3816,4186
307,2011-11-03,4,0,11,1,0.702083,318,3656,3974
308,2011-11-04,4,0,11,2,0.6225,470,3576,4046
309,2011-11-05,4,0,11,1,0.519167,1156,2770,3926
310,2011-11-06,4,0,11,1,0.734583,952,2697,3649
311,2011-11-07,4,0,11,1,0.75875,373,3662,4035
312,2011-11-08,4,0,11,1,0.721667,376,3829,4205
313,2011-11-09,4,0,11,1,0.758333,305,3804,4109
314,2011-11-10,4,0,11,2,0.813333,190,2743,2933
315,2011-11-11,4,0,11,1,0.44625,440,2928,3368
316,2011-11-12,4,0,11,1,0.552917,1275,2792,4067
317,2011-11-13,4,0,11,1,0.458333,1004,2713,3717
318,2011-11-14,4,0,11,1,0.587083,595,3891,4486
319,2011-11-15,4,0,11,2,0.68875,449,3746,4195
320,2011-11-16,4,0,11,3,0.93,145,1672,1817
321,2011-11-17,4,0,11,2,0.575833,139,2914,3053
322,2011-11-18,4,0,11,1,0.41,245,3147,3392
323,2011-11-19,4,0,11,1,0.502083,943,2720,3663
324,2011-11-20,4,0,11,2,0.684583,787,2733,3520
325,2011-11-21,4,0,11,3,0.91,220,2545,2765
326,2011-11-22,4,0,11,3,0.9625,69,1538,1607
327,2011-11-23,4,0,11,2,0.757917,112,2454,2566
328,2011-11-24,4,0,11,1,0.549167,560,935,1495
329,2011-11-25,4,0,11,1,0.64375,1095,1697,2792
330,2011-11-26,4,0,11,1,0.681667,1249,1819,3068
331,2011-11-27,4,0,11,1,0.698333,810,2261,3071
332,2011-11-28,4,0,11,1,0.743043,253,3614,3867
333,2011-11-29,4,0,11,2,0.830833,96,2818,2914
334,2011-11-30,4,0,11,1,0.613333,188,3425,3613
335,2011-12-01,4,0,12,1,0.524583,182,3545,3727
336,2011-12-02,4,0,12,1,0.625833,268,3672,3940
337,2011-12-03,4,0,12,1,0.612917,706,2908,3614
338,2011-12-04,4,0,12,1,0.775833,634,2851,3485
339,2011-12-05,4,0,12,2,0.827083,233,3578,3811
340,2011-12-06,4,0,12,3,0.949583,126,2468,2594
341,2011-12-07,4,0,12,3,0.970417,50,655,705
342,2011-12-08,4,0,12,1,0.58,150,3172,3322
343,2011-12-09,4,0,12,1,0.695833,261,3359,3620
344,2011-12-10,4,0,12,1,0.5075,502,2688,3190
345,2011-12-11,4,0,12,1,0.49,377,2366,2743
346,2011-12-12,4,0,12,1,0.670833,143,3167,3310
347,2011-12-13,4,0,12,1,0.59,155,3368,3523
348,2011-12-14,4,0,12,2,0.66375,178,3562,3740
349,2011-12-15,4,0,12,2,0.634167,181,3528,3709
350,2011-12-16,4,0,12,2,0.500417,178,3399,3577
351,2011-12-17,4,0,12,2,0.560833,275,2464,2739
352,2011-12-18,4,0,12,1,0.58625,220,2211,2431
353,2011-12-19,4,0,12,1,0.6375,260,3143,3403
354,2011-12-20,4,0,12,2,0.595417,216,3534,3750
355,2011-12-21,1,0,12,2,0.858333,107,2553,2660
356,2011-12-22,1,0,12,2,0.7575,227,2841,3068
357,2011-12-23,1,0,12,1,0.68625,163,2046,2209
358,2011-12-24,1,0,12,1,0.5425,155,856,1011
359,2011-12-25,1,0,12,1,0.681304,303,451,754
360,2011-12-26,1,0,12,1,0.506957,430,887,1317
361,2011-12-27,1,0,12,2,0.7625,103,1059,1162
362,2011-12-28,1,0,12,1,0.503913,255,2047,2302
363,2011-12-29,1,0,12,1,0.574167,254,2169,2423
364,2011-12-30,1,0,12,1,0.636667,491,2508,2999
365,2011-12-31,1,0,12,1,0.615833,665,1820,2485
366,2012-01-01,1,1,1,1,0.6925,686,1608,2294
367,2012-01-02,1,1,1,1,0.381304,244,1707,1951
368,2012-01-03,1,1,1,1,0.44125,89,2147,2236
369,2012-01-04,1,1,1,2,0.414583,95,2273,2368
370,2012-01-05,1,1,1,1,0.524167,140,3132,3272
371,2012-01-06,1,1,1,1,0.542083,307,3791,4098
372,2012-01-07,1,1,1,1,0.531667,1070,3451,4521
373,2012-01-08,1,1,1,1,0.465,599,2826,3425
374,2012-01-09,1,1,1,2,0.701667,106,2270,2376
375,2012-01-10,1,1,1,1,0.646522,173,3425,3598
376,2012-01-11,1,1,1,2,0.8475,92,2085,2177
377,2012-01-12,1,1,1,2,0.802917,269,3828,4097
378,2012-01-13,1,1,1,1,0.5075,174,3040,3214
379,2012-01-14,1,1,1,1,0.4575,333,2160,2493
380,2012-01-15,1,1,1,1,0.419167,284,2027,2311
381,2012-01-16,1,1,1,1,0.5225,217,2081,2298
382,2012-01-17,1,1,1,2,0.716087,127,2808,2935
383,2012-01-18,1,1,1,1,0.443333,109,3267,3376
384,2012-01-19,1,1,1,1,0.4975,130,3162,3292
385,2012-01-20,1,1,1,2,0.45,115,3048,3163
386,2012-01-21,1,1,1,2,0.83125,67,1234,1301
387,2012-01-22,1,1,1,2,0.79625,196,1781,1977
388,2012-01-23,1,1,1,2,0.91125,145,2287,2432
389,2012-01-24,1,1,1,1,0.835833,439,3900,4339
390,2012-01-25,1,1,1,1,0.64375,467,3803,4270
391,2012-01-26,1,1,1,2,0.769583,244,3831,4075
392,2012-01-27,1,1,1,2,0.74125,269,3187,3456
393,2012-01-28,1,1,1,1,0.543333,775,3248,4023
394,2012-01-29,1,1,1,1,0.31125,558,2685,3243
395,2012-01-30,1,1,1,1,0.400833,126,3498,3624
396,2012-01-31,1,1,1,1,0.416667,324,4185,4509
397,2012-02-01,1,1,2,1,0.507917,304,4275,4579
398,2012-02-02,1,1,2,2,0.672917,190,3571,3761
399,2012-02-03,1,1,2,1,0.526667,310,3841,4151
400,2012-02-04,1,1,2,2,0.779583,384,2448,2832
401,2012-02-05,1,1,2,2,0.687917,318,2629,2947
402,2012-02-06,1,1,2,1,0.622174,206,3578,3784
403,2012-02-07,1,1,2,1,0.49625,199,4176,4375
404,2012-02-08,1,1,2,2,0.722917,109,2693,2802
405,2012-02-09,1,1,2,1,0.562083,163,3667,3830
406,2012-02-10,1,1,2,2,0.54,227,3604,3831
407,2012-02-11,1,1,2,3,0.73125,192,1977,2169
408,2012-02-12,1,1,2,1,0.464583,73,1456,1529
409,2012-02-13,1,1,2,1,0.41125,94,3328,3422
410,2012-02-14,1,1,2,2,0.50875,135,3787,3922
411,2012-02-15,1,1,2,1,0.53125,141,4028,4169
412,2012-02-16,1,1,2,2,0.752917,74,2931,3005
413,2012-02-17,1,1,2,1,0.634583,349,3805,4154
414,2012-02-18,1,1,2,1,0.534583,1435,2883,4318
415,2012-02-19,1,1,2,2,0.515833,618,2071,2689
416,2012-02-20,1,1,2,1,0.507826,502,2627,3129
417,2012-02-21,1,1,2,1,0.594348,163,3614,3777
418,2012-02-22,1,1,2,1,0.567917,394,4379,4773
419,2012-02-23,1,1,2,1,0.554583,516,4546,5062
420,2012-02-24,1,1,2,2,0.7375,246,3241,3487
421,2012-02-25,1,1,2,1,0.395833,317,2415,2732
422,2012-02-26,1,1,2,1,0.41,515,2874,3389
423,2012-02-27,1,1,2,1,0.490833,253,4069,4322
424,2012-02-28,1,1,2,1,0.395833,229,4134,4363
425,2012-02-29,1,1,2,2,0.804783,65,1769,1834
426,2012-03-01,1,1,3,1,0.615417,325,4665,4990
427,2012-03-02,1,1,3,2,0.657083,246,2948,3194
428,2012-03-03,1,1,3,2,0.62125,956,3110,4066
429,2012-03-04,1,1,3,1,0.403333,710,2713,3423
430,2012-03-05,1,1,3,1,0.50625,203,3130,3333
431,2012-03-06,1,1,3,1,0.456667,221,3735,3956
432,2012-03-07,1,1,3,1,0.513333,432,4484,4916
433,2012-03-08,1,1,3,1,0.5675,486,4896,5382
434,2012-03-09,1,1,3,2,0.407083,447,4122,4569
435,2012-03-10,1,1,3,1,0.350417,968,3150,4118
436,2012-03-11,1,1,3,1,0.476957,1658,3253,4911
437,2012-03-12,1,1,3,1,0.489167,838,4460,5298
438,2012-03-13,1,1,3,1,0.6175,762,5085,5847
439,2012-03-14,1,1,3,1,0.507083,997,5315,6312
440,2012-03-15,1,1,3,1,0.579583,1005,5187,6192
441,2012-03-16,1,1,3,2,0.842083,548,3830,4378
442,2012-03-17,1,1,3,2,0.755833,3155,4681,7836
443,2012-03-18,1,1,3,2,0.81,2207,3685,5892
444,2012-03-19,1,1,3,1,0.72875,982,5171,6153
445,2012-03-20,1,1,3,1,0.807917,1051,5042,6093
446,2012-03-21,2,1,3,2,0.82125,1122,5108,6230
447,2012-03-22,2,1,3,1,0.83125,1334,5537,6871
448,2012-03-23,2,1,3,2,0.694167,2469,5893,8362
449,2012-03-24,2,1,3,2,0.885417,1033,2339,3372
450,2012-03-25,2,1,3,2,0.880833,1532,3464,4996
451,2012-03-26,2,1,3,1,0.477917,795,4763,5558
452,2012-03-27,2,1,3,1,0.29,531,4571,5102
453,2012-03-28,2,1,3,1,0.48125,674,5024,5698
454,2012-03-29,2,1,3,1,0.439167,834,5299,6133
455,2012-03-30,2,1,3,2,0.580833,796,4663,5459
456,2012-03-31,2,1,3,2,0.738333,2301,3934,6235
457,2012-04-01,2,1,4,2,0.67625,2347,3694,6041
458,2012-04-02,2,1,4,1,0.504348,1208,4728,5936
459,2012-04-03,2,1,4,1,0.396667,1348,5424,6772
460,2012-04-04,2,1,4,1,0.469583,1058,5378,6436
461,2012-04-05,2,1,4,1,0.374167,1192,5265,6457
462,2012-04-06,2,1,4,1,0.377083,1807,4653,6460
463,2012-04-07,2,1,4,1,0.254167,3252,3605,6857
464,2012-04-08,2,1,4,1,0.275833,2230,2939,5169
465,2012-04-09,2,1,4,1,0.3175,905,4680,5585
466,2012-04-10,2,1,4,1,0.435,819,5099,5918
467,2012-04-11,2,1,4,1,0.469565,482,4380,4862
468,2012-04-12,2,1,4,1,0.46625,663,4746,5409
469,2012-04-13,2,1,4,1,0.408333,1252,5146,6398
470,2012-04-14,2,1,4,1,0.502917,2795,4665,7460
471,2012-04-15,2,1,4,1,0.507917,2846,4286,7132
472,2012-04-16,2,1,4,1,0.561667,1198,5172,6370
473,2012-04-17,2,1,4,1,0.390417,989,5702,6691
474,2012-04-18,2,1,4,2,0.569167,347,4020,4367
475,2012-04-19,2,1,4,1,0.6125,846,5719,6565
476,2012-04-20,2,1,4,1,0.694583,1340,5950,7290
477,2012-04-21,2,1,4,1,0.682917,2541,4083,6624
478,2012-04-22,2,1,4,3,0.835417,120,907,1027
479,2012-04-23,2,1,4,2,0.766667,195,3019,3214
480,2012-04-24,2,1,4,1,0.454167,518,5115,5633
481,2012-04-25,2,1,4,1,0.427917,655,5541,6196
482,2012-04-26,2,1,4,2,0.756667,475,4551,5026
483,2012-04-27,2,1,4,1,0.400833,1014,5219,6233
484,2012-04-28,2,1,4,2,0.489583,1120,3100,4220
485,2012-04-29,2,1,4,1,0.587083,2229,4075,6304
486,2012-04-30,2,1,4,2,0.57,665,4907,5572
487,2012-05-01,2,1,5,2,0.659583,653,5087,5740
488,2012-05-02,2,1,5,1,0.797083,667,5502,6169
489,2012-05-03,2,1,5,2,0.768333,764,5657,6421
490,2012-05-04,2,1,5,1,0.735417,1069,5227,6296
491,2012-05-05,2,1,5,2,0.756667,2496,4387,6883
492,2012-05-06,2,1,5,2,0.74,2135,4224,6359
493,2012-05-07,2,1,5,2,0.664167,1008,5265,6273
494,2012-05-08,2,1,5,2,0.685833,738,4990,5728
495,2012-05-09,2,1,5,2,0.744167,620,4097,4717
496,2012-05-10,2,1,5,1,0.552083,1026,5546,6572
497,2012-05-11,2,1,5,1,0.360417,1319,5711,7030
498,2012-05-12,2,1,5,1,0.480417,2622,4807,7429
499,2012-05-13,2,1,5,1,0.57625,2172,3946,6118
500,2012-05-14,2,1,5,2,0.789583,342,2501,2843
501,2012-05-15,2,1,5,2,0.794583,625,4490,5115
502,2012-05-16,2,1,5,1,0.697917,991,6433,7424
503,2012-05-17,2,1,5,1,0.52,1242,6142,7384
504,2012-05-18,2,1,5,1,0.523333,1521,6118,7639
505,2012-05-19,2,1,5,1,0.45625,3410,4884,8294
506,2012-05-20,2,1,5,1,0.530417,2704,4425,7129
507,2012-05-21,2,1,5,2,0.81125,630,3729,4359
508,2012-05-22,2,1,5,2,0.765833,819,5254,6073
509,2012-05-23,2,1,5,2,0.774583,766,4494,5260
510,2012-05-24,2,1,5,1,0.716667,1059,5711,6770
511,2012-05-25,2,1,5,1,0.747083,1417,5317,6734
512,2012-05-26,2,1,5,1,0.7325,2855,3681,6536
513,2012-05-27,2,1,5,1,0.697083,3283,3308,6591
514,2012-05-28,2,1,5,1,0.67625,2557,3486,6043
515,2012-05-29,2,1,5,1,0.684583,880,4863,5743
516,2012-05-30,2,1,5,2,0.67,745,6110,6855
517,2012-05-31,2,1,5,1,0.492917,1100,6238,7338
518,2012-06-01,2,1,6,2,0.755417,533,3594,4127
519,2012-06-02,2,1,6,1,0.549167,2795,5325,8120
520,2012-06-03,2,1,6,1,0.493333,2494,5147,7641
521,2012-06-04,2,1,6,1,0.487083,1071,5927,6998
522,2012-06-05,2,1,6,2,0.613333,968,6033,7001
523,2012-06-06,2,1,6,1,0.61125,1027,6028,7055
524,2012-06-07,2,1,6,1,0.567083,1038,6456,7494
525,2012-06-08,2,1,6,1,0.467917,1488,6248,7736
526,2012-06-09,2,1,6,1,0.437083,2708,4790,7498
527,2012-06-10,2,1,6,1,0.538333,2224,4374,6598
528,2012-06-11,2,1,6,2,0.587917,1017,5647,6664
529,2012-06-12,2,1,6,2,0.833333,477,4495,4972
530,2012-06-13,2,1,6,1,0.582083,1173,6248,7421
531,2012-06-14,2,1,6,1,0.569583,1180,6183,7363
532,2012-06-15,2,1,6,1,0.589583,1563,6102,7665
533,2012-06-16,2,1,6,1,0.504167,2963,4739,7702
534,2012-06-17,2,1,6,1,0.59875,2634,4344,6978
535,2012-06-18,2,1,6,2,0.777917,653,4446,5099
536,2012-06-19,2,1,6,1,0.69,968,5857,6825
537,2012-06-20,2,1,6,1,0.592083,872,5339,6211
538,2012-06-21,3,1,6,1,0.567917,778,5127,5905
539,2012-06-22,3,1,6,1,0.57375,964,4859,5823
540,2012-06-23,3,1,6,1,0.534583,2657,4801,7458
541,2012-06-24,3,1,6,1,0.479167,2551,4340,6891
542,2012-06-25,3,1,6,1,0.504167,1139,5640,6779
543,2012-06-26,3,1,6,1,0.373333,1077,6365,7442
544,2012-06-27,3,1,6,1,0.36,1077,6258,7335
545,2012-06-28,3,1,6,1,0.4225,921,5958,6879
546,2012-06-29,3,1,6,1,0.48875,829,4634,5463
547,2012-06-30,3,1,6,1,0.60125,1455,4232,5687
548,2012-07-01,3,1,7,1,0.51875,1421,4110,5531
549,2012-07-02,3,1,7,1,0.447083,904,5323,6227
550,2012-07-03,3,1,7,1,0.492083,1052,5608,6660
551,2012-07-04,3,1,7,1,0.53875,2562,4841,7403
552,2012-07-05,3,1,7,1,0.457917,1405,4836,6241
553,2012-07-06,3,1,7,1,0.450833,1366,4841,6207
554,2012-07-07,3,1,7,1,0.492083,1448,3392,4840
555,2012-07-08,3,1,7,1,0.57375,1203,3469,4672
556,2012-07-09,3,1,7,2,0.683333,998,5571,6569
557,2012-07-10,3,1,7,2,0.6675,954,5336,6290
558,2012-07-11,3,1,7,1,0.633333,975,6289,7264
559,2012-07-12,3,1,7,1,0.529583,1032,6414,7446
560,2012-07-13,3,1,7,2,0.485833,1511,5988,7499
561,2012-07-14,3,1,7,2,0.699167,2355,4614,6969
562,2012-07-15,3,1,7,1,0.717917,1920,4111,6031
563,2012-07-16,3,1,7,1,0.645,1088,5742,6830
564,2012-07-17,3,1,7,1,0.505833,921,5865,6786
565,2012-07-18,3,1,7,1,0.577083,799,4914,5713
566,2012-07-19,3,1,7,1,0.600417,888,5703,6591
567,2012-07-20,3,1,7,2,0.844167,747,5123,5870
568,2012-07-21,3,1,7,3,0.865417,1264,3195,4459
569,2012-07-22,3,1,7,2,0.7625,2544,4866,7410
570,2012-07-23,3,1,7,1,0.694167,1135,5831,6966
571,2012-07-24,3,1,7,1,0.655,1140,6452,7592
572,2012-07-25,3,1,7,1,0.45,1383,6790,8173
573,2012-07-26,3,1,7,1,0.596667,1036,5825,6861
574,2012-07-27,3,1,7,1,0.594583,1259,5645,6904
575,2012-07-28,3,1,7,1,0.613333,2234,4451,6685
576,2012-07-29,3,1,7,1,0.62375,2153,4444,6597
577,2012-07-30,3,1,7,1,0.66875,1040,6065,7105
578,2012-07-31,3,1,7,1,0.704167,968,6248,7216
579,2012-08-01,3,1,8,1,0.6775,1074,6506,7580
580,2012-08-02,3,1,8,1,0.659583,983,6278,7261
581,2012-08-03,3,1,8,2,0.6425,1328,5847,7175
582,2012-08-04,3,1,8,1,0.613333,2345,4479,6824
583,2012-08-05,3,1,8,1,0.6525,1707,3757,5464
584,2012-08-06,3,1,8,2,0.654167,1233,5780,7013
585,2012-08-07,3,1,8,2,0.70375,1278,5995,7273
586,2012-08-08,3,1,8,2,0.672917,1263,6271,7534
587,2012-08-09,3,1,8,1,0.620417,1196,6090,7286
588,2012-08-10,3,1,8,2,0.715833,1065,4721,5786
589,2012-08-11,3,1,8,2,0.732917,2247,4052,6299
590,2012-08-12,3,1,8,1,0.530417,2182,4362,6544
591,2012-08-13,3,1,8,1,0.545417,1207,5676,6883
592,2012-08-14,3,1,8,1,0.686667,1128,5656,6784
593,2012-08-15,3,1,8,1,0.619583,1198,6149,7347
594,2012-08-16,3,1,8,1,0.519167,1338,6267,7605
595,2012-08-17,3,1,8,1,0.570833,1483,5665,7148
596,2012-08-18,3,1,8,1,0.603333,2827,5038,7865
597,2012-08-19,3,1,8,2,0.711667,1208,3341,4549
598,2012-08-20,3,1,8,2,0.734167,1026,5504,6530
599,2012-08-21,3,1,8,1,0.67375,1081,5925,7006
600,2012-08-22,3,1,8,1,0.677083,1094,6281,7375
601,2012-08-23,3,1,8,1,0.635833,1363,6402,7765
602,2012-08-24,3,1,8,2,0.615,1325,6257,7582
603,2012-08-25,3,1,8,2,0.712917,1829,4224,6053
604,2012-08-26,3,1,8,2,0.845833,1483,3772,5255
605,2012-08-27,3,1,8,1,0.730417,989,5928,6917
606,2012-08-28,3,1,8,1,0.62,935,6105,7040
607,2012-08-29,3,1,8,1,0.552083,1177,6520,7697
608,2012-08-30,3,1,8,1,0.590417,1172,6541,7713
609,2012-08-31,3,1,8,1,0.5875,1433,5917,7350
610,2012-09-01,3,1,9,2,0.638333,2352,3788,6140
611,2012-09-02,3,1,9,2,0.815,2613,3197,5810
612,2012-09-03,3,1,9,1,0.790833,1965,4069,6034
613,2012-09-04,3,1,9,1,0.755,867,5997,6864
614,2012-09-05,3,1,9,1,0.74125,832,6280,7112
615,2012-09-06,3,1,9,2,0.810417,611,5592,6203
616,2012-09-07,3,1,9,1,0.73625,1045,6459,7504
617,2012-09-08,3,1,9,2,0.799167,1557,4419,5976
618,2012-09-09,3,1,9,1,0.5475,2570,5657,8227
619,2012-09-10,3,1,9,1,0.50375,1118,6407,7525
620,2012-09-11,3,1,9,1,0.52,1070,6697,7767
621,2012-09-12,3,1,9,1,0.577083,1050,6820,7870
622,2012-09-13,3,1,9,1,0.637083,1054,6750,7804
623,2012-09-14,3,1,9,1,0.6725,1379,6630,8009
624,2012-09-15,3,1,9,1,0.501667,3160,5554,8714
625,2012-09-16,3,1,9,1,0.57,2166,5167,7333
626,2012-09-17,3,1,9,2,0.734583,1022,5847,6869
627,2012-09-18,3,1,9,2,0.8725,371,3702,4073
628,2012-09-19,3,1,9,1,0.536667,788,6803,7591
629,2012-09-20,3,1,9,1,0.618333,939,6781,7720
630,2012-09-21,3,1,9,1,0.66875,1250,6917,8167
631,2012-09-22,3,1,9,1,0.646667,2512,5883,8395
632,2012-09-23,4,1,9,1,0.467083,2454,5453,7907
633,2012-09-24,4,1,9,1,0.492917,1001,6435,7436
634,2012-09-25,4,1,9,1,0.57,845,6693,7538
635,2012-09-26,4,1,9,1,0.630833,787,6946,7733
636,2012-09-27,4,1,9,2,0.690833,751,6642,7393
637,2012-09-28,4,1,9,2,0.69,1045,6370,7415
638,2012-09-29,4,1,9,1,0.542917,2589,5966,8555
639,2012-09-30,4,1,9,1,0.583333,2015,4874,6889
640,2012-10-01,4,1,10,2,0.649167,763,6015,6778
641,2012-10-02,4,1,10,3,0.871667,315,4324,4639
642,2012-10-03,4,1,10,2,0.79375,728,6844,7572
643,2012-10-04,4,1,10,2,0.722917,891,6437,7328
644,2012-10-05,4,1,10,1,0.6275,1516,6640,8156
645,2012-10-06,4,1,10,1,0.664167,3031,4934,7965
646,2012-10-07,4,1,10,2,0.708333,781,2729,3510
647,2012-10-08,4,1,10,2,0.709583,874,4604,5478
648,2012-10-09,4,1,10,2,0.761667,601,5791,6392
649,2012-10-10,4,1,10,1,0.630833,780,6911,7691
650,2012-10-11,4,1,10,1,0.463333,834,6736,7570
651,2012-10-12,4,1,10,1,0.539167,1060,6222,7282
652,2012-10-13,4,1,10,1,0.494583,2252,4857,7109
653,2012-10-14,4,1,10,1,0.640417,2080,4559,6639
654,2012-10-15,4,1,10,2,0.7075,760,5115,5875
655,2012-10-16,4,1,10,1,0.558333,922,6612,7534
656,2012-10-17,4,1,10,1,0.692917,979,6482,7461
657,2012-10-18,4,1,10,2,0.728333,1008,6501,7509
658,2012-10-19,4,1,10,2,0.815,753,4671,5424
659,2012-10-20,4,1,10,1,0.572917,2806,5284,8090
660,2012-10-21,4,1,10,1,0.51,2132,4692,6824
661,2012-10-22,4,1,10,1,0.568333,830,6228,7058
662,2012-10-23,4,1,10,1,0.641667,841,6625,7466
663,2012-10-24,4,1,10,1,0.63625,795,6898,7693
664,2012-10-25,4,1,10,2,0.800417,875,6484,7359
665,2012-10-26,4,1,10,2,0.807083,1182,6262,7444
666,2012-10-27,4,1,10,2,0.72,2643,5209,7852
667,2012-10-28,4,1,10,2,0.694583,998,3461,4459
668,2012-10-29,4,1,10,3,0.88,2,20,22
669,2012-10-30,4,1,10,2,0.825455,87,1009,1096
670,2012-10-31,4,1,10,2,0.666667,419,5147,5566
671,2012-11-01,4,1,11,2,0.581667,466,5520,5986
672,2012-11-02,4,1,11,1,0.522083,618,5229,5847
673,2012-11-03,4,1,11,2,0.49125,1029,4109,5138
674,2012-11-04,4,1,11,1,0.532917,1201,3906,5107
675,2012-11-05,4,1,11,1,0.494167,378,4881,5259
676,2012-11-06,4,1,11,1,0.567083,466,5220,5686
677,2012-11-07,4,1,11,2,0.5475,326,4709,5035
678,2012-11-08,4,1,11,1,0.333478,340,4975,5315
679,2012-11-09,4,1,11,1,0.540833,709,5283,5992
680,2012-11-10,4,1,11,1,0.645417,2090,4446,6536
681,2012-11-11,4,1,11,1,0.659167,2290,4562,6852
682,2012-11-12,4,1,11,1,0.741667,1097,5172,6269
683,2012-11-13,4,1,11,2,0.662917,327,3767,4094
684,2012-11-14,4,1,11,1,0.552083,373,5122,5495
685,2012-11-15,4,1,11,2,0.620417,320,5125,5445
686,2012-11-16,4,1,11,1,0.524583,484,5214,5698
687,2012-11-17,4,1,11,1,0.545417,1313,4316,5629
688,2012-11-18,4,1,11,1,0.692917,922,3747,4669
689,2012-11-19,4,1,11,2,0.623333,449,5050,5499
690,2012-11-20,4,1,11,2,0.685,534,5100,5634
691,2012-11-21,4,1,11,1,0.61375,615,4531,5146
692,2012-11-22,4,1,11,1,0.580417,955,1470,2425
693,2012-11-23,4,1,11,1,0.56875,1603,2307,3910
694,2012-11-24,4,1,11,1,0.404583,532,1745,2277
695,2012-11-25,4,1,11,1,0.468333,309,2115,2424
696,2012-11-26,4,1,11,1,0.535417,337,4750,5087
697,2012-11-27,4,1,11,2,0.786667,123,3836,3959
698,2012-11-28,4,1,11,1,0.50625,198,5062,5260
699,2012-11-29,4,1,11,1,0.555652,243,5080,5323
700,2012-11-30,4,1,11,1,0.649583,362,5306,5668
701,2012-12-01,4,1,12,2,0.806667,951,4240,5191
702,2012-12-02,4,1,12,2,0.823333,892,3757,4649
703,2012-12-03,4,1,12,1,0.7675,555,5679,6234
704,2012-12-04,4,1,12,1,0.73375,551,6055,6606
705,2012-12-05,4,1,12,1,0.485,331,5398,5729
706,2012-12-06,4,1,12,1,0.50875,340,5035,5375
707,2012-12-07,4,1,12,2,0.764167,349,4659,5008
708,2012-12-08,4,1,12,2,0.91125,1153,4429,5582
709,2012-12-09,4,1,12,2,0.905417,441,2787,3228
710,2012-12-10,4,1,12,2,0.925,329,4841,5170
711,2012-12-11,4,1,12,2,0.596667,282,5219,5501
712,2012-12-12,4,1,12,2,0.538333,310,5009,5319
713,2012-12-13,4,1,12,1,0.485833,425,5107,5532
714,2012-12-14,4,1,12,1,0.642917,429,5182,5611
715,2012-12-15,4,1,12,1,0.650417,767,4280,5047
716,2012-12-16,4,1,12,2,0.83875,538,3248,3786
717,2012-12-17,4,1,12,2,0.907083,212,4373,4585
718,2012-12-18,4,1,12,1,0.66625,433,5124,5557
719,2012-12-19,4,1,12,1,0.625417,333,4934,5267
720,2012-12-20,4,1,12,2,0.667917,314,3814,4128
721,2012-12-21,1,1,12,2,0.556667,221,3402,3623
722,2012-12-22,1,1,12,1,0.44125,205,1544,1749
723,2012-12-23,1,1,12,1,0.515417,408,1379,1787
724,2012-12-24,1,1,12,2,0.791304,174,746,920
725,2012-12-25,1,1,12,2,0.734783,440,573,1013
726,2012-12-26,1,1,12,3,0.823333,9,432,441
727,2012-12-27,1,1,12,2,0.652917,247,1867,2114
728,2012-12-28,1,1,12,2,0.59,644,2451,3095
729,2012-12-29,1,1,12,2,0.752917,159,1182,1341
730,2012-12-30,1,1,12,1,0.483333,364,1432,1796
731,2012-12-31,1,1,12,2,0.5775,439,2290,2729
